102
60
000000000000000000000000000000000000000000000000000000000000000000000000000000000000000000000000000000
000000000000000000000000000000000000000000000000000000000000000000000000000000000000000000000000000000
000000000000000000000000000000000000000000000000000000000000000000000000000000000000000000000000000000
000000000000000000000000000000000000000000000000000000000000000000000000000000000000000000000000000000
000000000000000000000000000000000000000000000000000000000000000000000000000000000000000000000000000000
000000000000000000000000000000000000000000000000000000000000000000000000000000000000000000000000000000
000000000000000000000000000000000000000000000000000000000000000000000000000000000000000000000000000000
000000000000000000000000000000000000000000000000000000000000000000000000000000000000000000000000000000
000000000000000000000000000000000000000000000000000000000000000000000000000000000000000000000000000000
000000000000000000000000000000000000000000000000000000000000000000000000000000000000000000000000000000
000000000000000000000000000000000000000000000000000000000000000000000000000000000000000000000000000000
000000000000000000000000000000000000000000000000000000000000000000000000000000000000000000000000000000
000000000000000000000000000000000000000000000000000000000000000000000000000000000000000000000000000000
000000000000000000000000000000000000000000000000000000000000000000000000000000000000000000000000000000
000000000000000000000000000000000000000000000000000000000000000000000000000000000000000000000000000000
000000000000000000000000000000000000000000000000000000000000000000000000000000000000000000000000000000
000000000000000000000000000000000000000000000000000000000000000000000000000000000000000000000000000000
000000000000000000000001111111111111111111111111111111111111111111111111111111100000000000000000000000
000000000000000000000001111111111111111111111111111111111111111111111111111111100000000000000000000000
000000000000000000000001111111111111111111111111111111111111111111111111111111100000000000000000000000
000000000000000000000001111111111111111111111111111111111111111111111111111111100000000000000000000000
000000000000000000000001111000000000000000000000000000000000000000000000000111100000000000000000000000
000000000000000000000001111000000000000000000000000000000000000000000000000111100000000000000000000000
000000000000000000000001111000000000000000000000000000000000000000000000000111100000000000000000000000
000000000000000000000001111000000000000000000000000000000000000000000000000111100000000000000000000000
000000000000000000000001111000000000000000000000000000000000000000000000000111100000000000000000000000
000000000000000000000001111000000000000000000000000000000000000000000000000111100000000000000000000000
000000000000000000000001111000000000000000000000000000000000000000000000000111100000000000000000000000
000000000000000000000001111000000000000000000000000000000000000000000000000111100000000000000000000000
000000000000000000000001111000000000000000000000000000000000000000000000000111100000000000000000000000
000000000000000000000001111000000000000000000000000000000000000000000000000111100000000000000000000000
000000000000000000000001111000000000000000000000000000000000000000000000000111100000000000000000000000
000000000000000000000001111000000000000000000000000000000000000000000000000111100000000000000000000000
000000000000000000000001111000000000000000000000000000000000000000000000000111100000000000000000000000
000000000000000000000001111000000000000000000000000000000000000000000000000111100000000000000000000000
000000000000000000000001111000000000000000000000000000000000000000000000000111100000000000000000000000
000000000000000000000001111000000000000000000000000000000000000000000000000111100000000000000000000000
000000000000000000000001111000000000000000000000000000000000000000000000000111100000000000000000000000
000000000000000000000001111111111111111111111110000000011111111111111111111111100000000000000000000000
000000000000000000000001111111111111111111111110000000011111111111111111111111100000000000000000000000
000000000000000000000001111111111111111111111110000000011111111111111111111111100000000000000000000000
000000000000000000000001111111111111111111111110000000011111111111111111111111100000000000000000000000
000000000000000000000000000000000000000000000000000000000000000000000000000000000000000000000000000000
000000000000000000000000000000000000000000000000000000000000000000000000000000000000000000000000000000
000000000000000000000000000000000000000000000000000000000000000000000000000000000000000000000000000000
000000000000000000000000000000000000000000000000000000000000000000000000000000000000000000000000000000
000000000000000000000000000000000000000000000000000000000000000000000000000000000000000000000000000000
000000000000000000000000000000000000000000000000000000000000000000000000000000000000000000000000000000
000000000000000000000000000000000000000000000000000000000000000000000000000000000000000000000000000000
000000000000000000000000000000000000000000000000000000000000000000000000000000000000000000000000000000
000000000000000000000000000000000000000000000000000000000000000000000000000000000000000000000000000000
000000000000000000000000000000000000000000000000000000000000000000000000000000000000000000000000000000
000000000000000000000000000000000000000000000000000000000000000000000000000000000000000000000000000000
000000000000000000000000000000000000000000000000000000000000000000000000000000000000000000000000000000
000000000000000000000000000000000000000000000000000000000000000000000000000000000000000000000000000000
000000000000000000000000000000000000000000000000000000000000000000000000000000000000000000000000000000
000000000000000000000000000000000000000000000000000000000000000000000000000000000000000000000000000000
000000000000000000000000000000000000000000000000000000000000000000000000000000000000000000000000000000
000000000000000000000000000000000000000000000000000000000000000000000000000000000000000000000000000000
000000000000000000000000000000000000000000000000000000000000000000000000000000000000000000000000000000
