60
102
G00000000000000000000000000000000000000000000000000000000000000000000000000000000000000000000000000000
000000000000000000000000000000000000000000000000000000000000000000000000000000000000000000000000000000
000000000000000000000000000000000000000000000000000000000000000000000000000000000000000000000000000000
000000000000000000000000000000000000000000000000000000000000000000000000000000000000000000000000000000
000000000000000000000000000000000000000000000000000000000000000000000000000000000000000000000000000000
000000000000000000000000000000000000000000000000000000000000000000000000000000000000000000000000000000
000000000000000000000000000000000000000000000000000000000000000000000000000000000000000000000000000000
000000000000000000000000000000000000000000000000000000000000000000000000000000000000000000000000000000
000000000000000000000000000000000000000000000000000000000000000000000000000000000000000000000000000000
000000000000000000000000000000000000000000000000000000000000000000000000000000000000000000000000000000
000000000000000000000000000000000000000000000000000000000000000000000000000000000000000000000000000000
000000000000000000000000000000000000000000000000000000000000000000000000000000000000000000000000000000
000000000000000000000000000000000000000000000000000000000000000000000000000000000000000000000000000000
000000000000000000000000000000000000000000000000000000000000000000000000000000000000000000000000000000
000000000000000000000000000000000000000000000000000000000000000000000000000000000000000000000000000000
000000000000000000000000000000000000000000000000000000000000000000000000000000000000000000000000000000
000000000000000000000000000000000000000000000000000000000000000000000000000000000000000000000000000000
000000000000000000000001111111111111111111111111111111111111111111111111111111100000000000000000000000
000000000000000000000001111111111111111111111111111111111111111111111111111111100000000000000000000000
000000000000000000000001111111111111111111111111111111111111111111111111111111100000000000000000000000
000000000000000000000001111111111111111111111111111111111111111111111111111111100000000000000000000000
000000000000000000000001111000000000000000000000000000000000000000000000000111100000000000000000000000
000000000000000000000001111000000000000000000000000000000000000000000000000111100000000000000000000000
00000000000000000000000111100000000S000000000000000000000000000000000000000111100000000000000000000000
000000000000000000000001111000000000000000000000000000000000000000000000000111100000000000000000000000
000000000000000000000001111000000000000000000000000000000000000000000000000111100000000000000000000000
000000000000000000000001111000000000000000000000000000000000000000000000000111100000000000000000000000
000000000000000000000001111000000000000000000000000000000000000000000000000111100000000000000000000000
000000000000000000000001111000000000000000000000000000000000000000000000000111100000000000000000000000
000000000000000000000001111000000000000000000000000000000000000000000000000111100000000000000000000000
0000000000000000000000011110000000000000000000000000S0000000000000000000000111100000000000000000000000
000000000000000000000001111000000000000000000000000000000000000000000000000111100000000000000000000000
000000000000000000000001111000000000000000000000000000000000000000000000000111100000000000000000000000
000000000000000000000001111000000000000000000000000000000000000000000000000111100000000000000000000000
000000000000000000000001111000000000000000000000000000000000000000000000000111100000000000000000000000
000000000000000000000001111000000000000000000000000000000000000000000000000111100000000000000000000000
000000000000000000000001111000000000000000000000000000000000000000000000000111100000000000000000000000
000000000000000000000001111000000000000000000000000000000000000000000000000111100000000000000000000000
000000000000000000000001111111111111111111111110000000011111111111111111111111100000000000000000000000
000000000000000000000001111111111111111111111110000000011111111111111111111111100000000000000000000000
000000000000000000000001111111111111111111111110000000011111111111111111111111100000000000000000000000
000000000000000000000001111111111111111111111110000000011111111111111111111111100000000000000000000000
000000000000000000000000000000000000000000000000000000000000000000000000000000000000000000000000000000
000000000000000000000000000000000000000000000000000000000000000000000000000000000000000000000000000000
000000000000000000000000000000000000000000000000000000000000000000000000000000000000000000000000000000
000000000000000000000000000000000000000000000000000000000000000000000000000000000000000000000000000000
000000000000000000000000000000000000000000000000000000000000000000000000000000000000000000000000000000
000000000000000000000000000000000000000000000000000000000000000000000000000000000000000000000000000000
000000000000000000000000000000000000000000000000000000000000000000000000000000000000000000000000000000
000000000000000000000000000000000000000000000000000000000000000000000000000000000000000000000000000000
000000000000000000000000000000000000000000000000000000000000000000000000000000000000000000000000000000
000000000000000000000000000000000000000000000000000000000000000000000000000000000000000000000000000000
000000000000000000000000000000000000000000000000000000000000000000000000000000000000000000000000000000
000000000000000000000000000000000000000000000000000000000000000000000000000000000000000000000000000000
000000000000000000000000000000000000000000000000000000000000000000000000000000000000000000000000000000
000000000000000000000000000000000000000000000000000000000000000000000000000000000000000000000000000000
000000000000000000000000000000000000000000000000000000000000000000000000000000000000000000000000000000
000000000000000000000000000000000000000000000000000000000000000000000000000000000000000000000000000000
000000000000000000000000000000000000000000000000000000000000000000000000000000000000000000000000000000
000000000000000000000000000000000000000000000000000000000000000000000000000000000000000000000000000000
