50
50
00000000000000000000001110000000000000000000000000
00G00000000000000000001110000000000000000000000000
00000000000000000000001110000000000000000000000000
00000000000000000000001110000000000000000000000000
00000000000000000000001110000000000000000000000000
00000000000000000000000110000000000000000000000000
00000000000000000000000110000000000000000000000000
00000000000000000000000110000000000000000000000000
00000000000000000000000110000000000000000000000000
00000000000000000000000110000000000000000000000000
00000000000000000000000110000000000000000000000000
00000000000000000000000110000000000000000000000000
00000000000000000000000110000000000000000000000000
00000000000000000000000110000000000000000000000000
00000000000000000000000110000000000000000000000000
00000000000000000000000110000000000000000000000000
00000000000000000000000110000000000000000000000000
00000000000000001011111110000000000000000000000000
00000000000000011111111100000000000000000000000000
00000000000000001110000000000000000000000000000000
00000000000000001100000000000000000000000000000000
00000000000000001100000000001110000000000000000000
00000000000000001100000111111111000000000000000000
00000000000000001100000111111011000000000000000000
00000000000000001110000000000011000000000000000000
00000000000000000110000000000011000000000000000000
00000000000000000110000000000011000000000000000000
00000000000000000111100000000011000000000000000000
00000000000000000111111110000011000000000000000000
00000000000000000001111110000011000000000000000000
00000000000000000000000000000011000000000000000000
00000000000000000000000000000011000000000000000000
00000000000000000000000000000011000000000000000000
00000000000000000000000000000011000000000000000000
00000000000000000000011111111111000000000000000000
00000000000000000000111111111111000000000000000000
00000000000000000000011000000000000000000000000000
00000000000000000000011000000000000000000000000000
00000000000000000000011000000000000000000000000000
00000000000000000000011000000000000000000000000000
00000000000000000000011000000000000000000000000000
00000000000000000000011000000000000000000000000000
00000000000000000000011000000000000000000000000000
00000000000000000000011000000000000000000000000000
00000000000000000000011000000000000000000000000000
00000000000000000000011000000000000000000000000000
00000000000000000000011000000000000000000000000000
000000000000000000000110000000000000000000000S0000
00000000000000000000011100000000000000000000000000
00000000000000000000011100000000000000000000000000
