30
30
G00001100000000000000000000000
000001100000000000000000000000
000001100000000000000000000000
000001100000000000000000000000
000000100000000000000000000000
000000100000000001111111110000
000000100000000000100000110000
000000100000000000100000110000
000000100000000000100000110000
000000100000000000100000110000
000000110000000000100000110000
000000110000000000100000110000
000000110000000000110000110000
000000110000000000110000110000
000000010000000000110000110000
000000010000000001110000110000
000000011111111111110000110000
000000011110000000000000110000
000000000000000000000000110000
000000000000000000000000110000
000000000000000000000000110000
000000000000000000000000110000
000000000000000000000000110000
000000111111100000000000110000
000000111111111111111111110000
000000000000000000000000000000
000000000000000000000000000000
000000000000000000000000000000
000000000000000000000000000000
00000000000000000000000000000S
