30
30
000000000000000000000000000000
000000000000000000000000000000
000000000000000000000000000000
111000000000000000000000000000
111111000000000000000000000000
111111111000000000000000000000
000111111111000000000000000000
000000111111111000000000000000
000000000111111111000000000000
000000000000111111110000000000
000000000000000111111000000000
000000000000000000111000000000
000000000000000000000000000000
000000000000000000000000000000
000000000000000000000000000000
000000000000000000000000000000
000000000110000000000000000000
000000001111110000000000000000
000000000111111110000000000000
000000000001111111110000000000
000000000000001111111111000000
000000000000000001111111111000
000000000000000000001111111111
000000000000000000000001111111
000000000000000000000000001111
000000000000000000000000000001
000000000000000000000000000000
000000000000000000000000000000
000000000000000000000000000000
000000000000000000000000000000
