97
57
0000000000000000000000000000001111000000000000000000000000000001111000000000000000000000000000000
0000000000000000000000000000001111000000000000000000000000000001111000000000000000000000000000000
0000000000000000000000000000001111000000000000000000000000000001111000000000000000000000000000000
0000000000000000000000000000001111000000000000000000000000000001111000000000000000000000000000000
0000000000000000000000000000001111000000000000000000000000000001111000000000000000000000000000000
0000000000000000000000000000001111000000000000000000000000000001111000000000000000000000000000000
0000000000000000000000000000001111000000000000000000000000000001111000000000000000000000000000000
0000000000000000000000000000000000000000000000000000000000000001111000000000000000000000000000000
0000000000000000000000000000000000000000000000000000000000000001111000000000000000000000000000000
0000000000000000000000000000000000000000000000000000000000000001111000000000000000000000000000000
0000000000000000000000000000001111000000000000000000000000000001111000000000000000000000000000000
0000000000000000000000000000001111000000000000000000000000000001111000000000000000000000000000000
0000000000000000000000000000001111000000000000000000000000000001111000000000000000000000000000000
0000000000000000000000000000001111000000000000000000000000000001111000000000000000000000000000000
0000000000000000000000000000001111000000000000000000000000000001111000000000000000000000000000000
0000000000000000000000000000001111000000000000000000000000000001111000000000000000000000000000000
0000000000000000000000000000001111000000000000000000000000000001111000000000000000000000000000000
0000000111111111111111111111111111111111111111111111100000000001111000000000000000000000000000000
0000000111111111111111111111111111111111111111111111100000000001111000000011111111111111111111111
0000000111111111111111111111111111111111111111111111100000000001111000000011111111111111111111111
0000000000000000000000000000001111000000000000000000000000000001111000000000000000000000000000000
0000000000000000000000000000001111000000000000000000000000000001111000000000000000000000000000000
0000000000000000000000000000001111000000000000000000000000000001111000000000000000000000000000000
0000000000000000000000000000001111000000000000000000000000000001111000000000000000000000000000000
0000000000000000000000000000001111000000000000000000000000000001111000000000000000000000000000000
0000000000000000000000000000001111000000000000000000000000000001111000000000000000000000000000000
0000000000000000000000000000001111000000000000000000000000000001111000000000000000000000000000000
0000000000000000000000000000001111000000000000000000000000000001111000000000000000000000000000000
0000000000000000000000000000001111000000000000000000000000000001111000000000000000000000000000000
0000000000000000000000000000001111000000000000000000000000000001111000000000000000000000000000000
0000000000000000000000000000001111000000000000000000000000000001111000000000000000000000000000000
0000000000000000000000000000001111000000000000000000000000000001111000000000000000000000000000000
0000000000000000000000000000001111000000000000000000000000000001111000000000000000000000000000000
0000000000000000000000000000001111000000000000000000000000000001111000000000000000000000000000000
0000000000000000000000000000001111000000000000000000000000000001111000000000000000000000000000000
0000000000000000000000000000001111000000000000000000000000000001111000000000000000000000000000000
0000000000000000000000000000001111000000000000000000000000000001111000000000000000000000000000000
1111111111111111111111111000001111000000011111111111111111111111111111111111111111111111110000000
1111111111111111111111111000001111000000011111111111111111111111111111111111111111111111110000000
0000000000000000000000000000001111000000000000000000000000000001111000000000000000000000000000000
0000000000000000000000000000001111000000000000000000000000000001111000000000000000000000000000000
0000000000000000000000000000001111000000000000000000000000000001111000000000000000000000000000000
0000000000000000000000000000001111000000000000000000000000000001111000000000000000000000000000000
0000000000000000000000000000001111000000000000000000000000000001111000000000000000000000000000000
0000000000000000000000000000001111000000000000000000000000000001111000000000000000000000000000000
0000000000000000000000000000001111000000000000000000000000000001111000000000000000000000000000000
0000000000000000000000000000001111000000000000000000000000000001111000000000000000000000000000000
0000000000000000000000000000001111000000000000000000000000000001111000000000000000000000000000000
0000000000000000000000000000001111000000000000000000000000000000000000000000000000000000000000000
0000000000000000000000000000001111000000000000000000000000000000000000000000000000000000000000000
0000000000000000000000000000001111000000000000000000000000000000000000000000000000000000000000000
0000000000000000000000000000001111000000000000000000000000000001111000000000000000000000000000000
0000000000000000000000000000001111000000000000000000000000000001111000000000000000000000000000000
0000000000000000000000000000001111000000000000000000000000000001111000000000000000000000000000000
0000000000000000000000000000001111000000000000000000000000000001111000000000000000000000000000000
0000000000000000000000000000001111000000000000000000000000000001111000000000000000000000000000000
0000000000000000000000000000001111000000000000000000000000000001111000000000000000000000000000000
