58
102
0000G0000000000000000000000000000000000000000000000000000000000000000000000000000000000000000000000000
000000000000000000000000000000000000000000000000000000000000000000000000000000000000000000000000000000
000000000000000000000000000000000000000000000000000000000000000000000000000000000000000000000000000000
000000000000000000000000000000000000000000000000000000000000000000000000000000000000000000000000000000
000000000000000000000000000000000000000000000000000000000000000000000000000000000000000000000000000000
000000000000000000000000000000000000000000000000000000000000000000000000000000000000000000000000000000
000000000000000000000000000000000000000000000000000000000000000000000000000000000000000000000000000000
000000000000000000000000000000000000000000000000000000000000000000000000000000000000000000000000000000
000000000000000000000000000000000000000000000000000000000000000000000000000000000000000000000000000000
000000000000000000000000000000000000000000000000000000000000000000000000000000000000000000000000000000
000000000000000000000000000000000000000000000000000000000000000000000000000000000000000000000000000000
000000000111111111111111111111111111111111111111111111111111111111111111111111111111111111000000000000
000000000111111111111111111111111111111111111111111111111111111111111111111111111111111111000000000000
000000000111111111111111111111111111111111111111111111111111111111111111111111111111111111000000000000
000000000111110000000000000000000000000000000001111100000000000000000000000000000000011111000000000000
000000000111110000000000000000000000000000000001111100000000000000000000000000000000011111000000000000
000000000111110000000000000000000000000000000001111100000000000000000000000000000000011111000000000000
000000000111110000000000000000000000000000000001111100000000000000000000000000000000011111000000000000
000000000111110000000000000000000000000000000001111100000000000000000000000000000000011111000000000000
000000000111110000000000000000000000000000000001111100000000000000000000000000000000011111000000000000
000000000111110000000000000000000000000000000001111100000000000000000000000000000000011111000000000000
000000000111110000000000000000000000000000000001111100000000000000000000000000000000011111000000000000
000000000111110000000000000000000000000000000001111100000000000000000000000000000000011111000000000000
000000000111110000000000000000000000000000000001111100000000000000000000000000000000011111000000000000
000000000111110000000000000000000000000000000001111100000000000000000000000000000000011111000000000000
000000000111110000000000000000000000000000000001111100000000000000000000000000000000011111000000000000
000000000111110000000000000000000000000000000001111100000000000000000000000000000000011111000000000000
000000000111110000000000000000000000000000000001111100000000000000000000000000000000011111000000000000
000000000111110000000000000000000000000000000001111100000000000000000000000000000000011111000000000000
000000000000000000000000000000000000000000000001111100000000000000000000000000000000000000000000000000
000000000000000000000000000000000000000000000001111100000000000000000000000000000000000000000000000000
000000000000000000000000000000000000000000000001111100000000000000000000000000000000000000000000000000
000000000000000000000000000000000000000000000001111100000000000000000000000000000000000000000000000000
000000000000000000000000000000000000000000000001111100000000000000000000000000000000000000000000000000
000000000000000000000000000000000000000000000001111100000000000000000000000000000000000000000000000000
000000000000000000000000000000000000000000000001111100000000000000000000000000000000000000000000000000
000000000000000000000000000000000000000000000001111100000000000000000000000000000000000000000000000000
000000000000000000000000000000000000000000000001111100000000000000000000000000000000000000000000000000
000000000000000000000000000000000000000000000001111100000000000000000000000000000000000000000000000000
000000000000000000000000000000000000000000000001111100000000000000000000000000000000000000000000000000
000000000000000000000000000000000000000000000001111100000000000000000000000000000000000000000000000000
000000000000000000000000000000000000000000000001111100000000000000000000000000000000000000000000000000
000000000000000000000000000000000000000000000001111100000000000000000000000000000000000000000000000000
000000000000000000000000000000000000000000000001111100000000000000000000000000000000000000000000000000
000000000000000000000000000000000000000000000001111100000000000000000000000000000000000000000000000000
000000000000000000000000000000000000000000000001111100000000000000000000000000000000000000000000000000
000000000000000000000000000000000000000000000001111100000000000000000000000000000000000000000000000000
000000000000000000000000000000000000000000000001111100000000000000000000000000000000000000000000000000
000000000000000000000000000000000000000000000001111100000000000000000000000000000000000000000000000000
000000000000000000000000000000000000000000000001111100000000000000000000000000000000000000000000000000
000000000000000000000000000000000000000000000001111100000000000000000000000000000000000000000000000000
000000000000000000000000000000000000000000000001111100000000000000000000000000000000000000000000000000
000000000000000000000000000000000000000000000001111100000000000000000000000000000000000000000000000000
000000000000000000000000000000000000000000000001111100000000000000000000000000000000000000000000000000
000000000000000000000000000000000000000000000001111100000000000000000000000000000000000000000000000000
000000000000000000000000000000000000000000000001111100000000000000000000000000000000000000000000000000
000000000000000000000000000000000000000000000001111100000000000000000000000000000000000000000000000000
00000000000000000000000000000000000000000000000111110000000000000000000000000000000000000000000000000S
